ATAGAGGGTCGCCGGCTCTGGATCA	spacer1
CCTCATGCTTGGGCGACAGCTTTTG	spacer2
CCGTGCTTCCAGTGATCGCCTTCTA	spacer3
ACGTCATACGCCGACCAATCATCAG	spacer4
TTTTCTGACCACTTGTGCGGGATTA	spacer5
CGTCGTCATTTCCGGCTTCAATTTC	spacer6
GAGGAGAGCGAGTACTCGGGGCTGC	spacer7
CGTGAAACCGCCCCCAGCCTCGCCG	spacer8
ACTCGGAATCCCATGTGCTGACAGC	spacer9
TCGACACCCGCTCTAGTTGACTTCC	spacer10
GTGAGCAACGGCGGCGGCAACCTGG	spacer11
ATATCTGCTGCCCGCCCGGGGAGAT	spacer12
GACCATCATTGCCATTCCCTCTCCC	spacer13
GGTGTGATGCGGATGGTCGGCTCGG	spacer14
CTTGAATAACGCGCAGTGAATTTCG	spacer15
CGAGTTCCCGTCAGCGTCGTAAATC	spacer16
GCGCCGGCCCGCGCGGATGACTCCG	spacer17
CATGGACCCGGGCGAGCTGCAGATG	spacer18
TAACTGGCTTGGCGCTGATCCTGGT	spacer19
TTGACCTCGCCAGGAGAGAAGATCA	spacer20
TCGATGTCGATGTCCCAATCGTCGA	spacer21
ACCGCAGACGGCACGATTGAGACAA	spacer22
AGCATCGCTGATGCGGTCCAGCTCG	spacer23
CCGCCTGCTGGGTGAGACGTGCTCG	spacer24
GATCAGCGACCACCGCACCCTGTCA	spacer25
CTTCAGCACCACCATCATCCGGCGC	spacer26
GGATTCGTGATCTCTTCCCGCGGAT	spacer27
TGCCCCGGCGTTTAGCGATCACAAC	spacer28
AAATACAGGCTCCACGACACGACCA	spacer29
GGTTGCCCCGCGCCCTTTTCCAGCC	spacer30
TCAGACAGGTTCGCGTCGATCAAGT	spacer31
GACCAAATAGGTATCGGCGTGTTCA	spacer32
GACATGACGGCGGTGCCGCACTTGA	spacer33
AAGTCACCTCGCCCACACCGTCGAA	spacer34
TCCGTACGCTCGAAACGCTTCCAAC	spacer35
CGAAATCCAGCACCACATCCGCAGC	spacer36
CGCGAACTCGTCCACAGTCCCCCTT	spacer37
CGTGGATGGCGGATGCGTTGTGCGC	spacer38
GACGATGGCCAGTAAATCGGCGTGG	spacer39
CGCCATCTGTGCCTCATACAGGTCC	spacer40
GGAGCTTTCCGGCTTCTATCAGGTA	spacer41
ATGGTGGGACATGGACGAGCGCGAC	spacer42
CGCAGAATCGCACCGGGTGCGGGAG	spacer43
